7	31					
1	1	1	1	1	1	1
1	1	902	902	902	1	1
1	1	0	0	0	1	1
1	0	0	0	0	0	1
1	0	0	0	0	0	1
1	0	0	0	0	0	1
1	0	0	0	0	0	1
1	0	0	0	0	0	1
1	0	0	0	0	0	1
1	0	0	0	0	0	1
1	0	0	0	0	0	1
1	0	0	0	0	0	1
1	0	0	0	0	0	1
1	0	0	0	0	0	1
1	0	0	0	0	0	1
1	0	0	0	0	0	1
1	0	0	0	0	0	1
1	0	0	0	0	0	1
1	0	0	0	0	0	1
1	0	0	0	0	0	1
1	0	0	0	0	0	1
1	0	0	0	0	0	1
1	0	0	0	0	0	1
1	0	0	0	0	0	1
1	0	0	0	0	0	1
1	0	0	0	0	0	1
1	0	0	0	0	0	1
1	0	0	0	0	0	1
1	1	0	0	0	1	1
1	1	901	901	901	1	1
1	1	1	1	1	1	1
